####### #######
#     # #     #
#     # #     #
#  ###   ###  #
# #         # #
# #         # #
# #         # #
# #         # #
# #         # #
# #         # #
# #         # #
#  ###   ###  #
#     # #     #
#     # #     #
####### #######