###############
# @           #
##     #####  #
##     #   #  #
##     #   #  #
##     #   #  #
########   #  #
#     ###     #
##     #      #
##            #
#######   #  ##
##        #####
##           ##
# ^    ########
###############