###############
#           # #
#           # #
#    ####   # #
#  ###  #   # #
#  #    #   # #
#  #   ##  ## #
#  #      ##  #
#  ####       #
#     #       #
#  ######  ## #
#  #  #    #  #
#  # ##  ###  #
#  #   ^ #    #
###############